			  ##\                 ##\                           
                    ## |                ## |                          
 #######\  ######\  ## |  ##\  ######\  #######\   ######\  #######\  
##  _____|##  __##\ ## | ##  |##  __##\ ##  __##\  \____##\ ##  __##\ 
\######\  ## /  ## |######  / ## /  ## |## |  ## | ####### |## |  ## |
 \____##\ ## |  ## |##  _##<  ## |  ## |## |  ## |##  __## |## |  ## |
#######  |\######  |## | \##\ \######  |#######  |\####### |## |  ## |
\_______/  \______/ \__|  \__| \______/ \_______/  \_______|\__|  \__|