11111111111111111
12222222222222221
12222222222222221
12222222222222221
12222222222222221
12222225222222221
12222222222222221
12222222222222221
12222224222222221
12222222222222221
12222222222222221
12222223222222221
12222222222222221
12222222222222221
12222222222222221
12222222222222221
12222222222222221
12222222222222221
12222222222222221
12222222222222221
12222222222222221
12222222222222221
12222222222222221
12222222222222221
12222222222222221
12222222222222221
12222222222222221
12222222222222221
12222222222222221
12222222222222221
12222222222222221
12222222222222221
12222222222222221
11111111111111111