1111111111
1222222221
1255555521
1255555521
1255555521
1255555521
1224222421
1222422221
1222322221
1111111111