1111111
1225221
1222221
1243221
1222221
1111111