111111111111
122522222221
122222222221
142322111111
122222166666
111111166666