666666666666611111111111111111111111111111111111111111111111111111111111111111111111111111111111
111111111111112222222222222222222222222222222222222222222222222222222422222222222222222222222521
122222222222222222222222222222222222222222222222222222222222222222222222222242222222222222225221
122222222222222222222225222222422222222222222322222222222222222222222222222222222222222242222521
122222222222222222222222222222222222222222222222222222222111112111122222222222222222222222222221
111111111112222222222222222222222222222222222222222222222166615166124222222222222222222222222221
666666666612222222222222222222222222222222222222222222222166611166122222222222222222222222222221
666666666611111111111111111111111111111111111111111111111166666666111111111111111111111111111111