1111111111111
1522152222221
1222222442521
1242321222221
1242221111111
1222521666666
1111111666666