6666111116666666666666
6666122216666666666666
6666142216666666666666
6611122411166666666666
6612242242166666666666
1112121112166666111111
1222121112111111122551
1242242222222222222551
1111121111213111122551
6666122222211166111111
6666111111116666666666