111111111
122222221
122252221
122252221
122252221
122242421
122232221
122222221
111111111