11111111111111111111111111111111111111111111111111111111111111111111111111111111111111111111111111111111111
12222222222222222222222222222222222222222222222222222222222222222222222222222222222222222222222222222222221
12222222222222222222222222222222222222222222222222222222222222222222222222222222222222222222222222222222221
12222222222222222222222522222242222222222222232222222222222222222222222222222222222222222222222222222222221
12222222222222222222222222222222222222222222222222222222222222222222222222222222222222222222222222222222221
12222222222222222222222222222222222222222222222222222222222222222222222222222222222222222222222222222222221
12222222222222222222222222222222222222222222222222222222222222222222222222222222222222222222222222222222221
11111111111111111111111111111111111111111111111111111111111111111111111111111111111111111111111111111111111