111111111111111111111111111111111111111111
122222222222222222221522222222222222222221
122222522222222222221222222222222222222221
122221112222222222221111122222222222222251
111222222221111222222222222222222222222221
122222222422222222223222222222422211111111
111111122222222222222222222222222222222221
122222122222222222222222244422222222222221
152222142222222222222222222222222222222221
122222222222222222222222222222222222222251
112222211111111111111111111111111111111111
612222516666666666666666666666666666666666
611111116666666666666666666666666666666666