66111111
11122221
12421211
12122521
12222121
11212221
61322111
61111166