111111111111
122512222221
122222244221
144232111111
122222166666
111111166666