1111111
1225221
1222221
1423221
1222221
1111111